ACTZTZTZ	ACCESSBANK TANZANIA LTD	TANZANIA, UNITED REPUBLIC OF
ADVBTZTZ	ADVANS BANK TANZANIA	TANZANIA, UNITED REPUBLIC OF
AKCOTZTZ	AKIBA COMMERCIAL BANK PLC	TANZANIA, UNITED REPUBLIC OF
AMNNTZTZ	AMANA BANK LIMITED	TANZANIA, UNITED REPUBLIC OF
AZANTZTZ	AZANIA BANK LIMITED	TANZANIA, UNITED REPUBLIC OF
BARBTZTZ	BANK OF BARODA (TANZANIA) LTD	TANZANIA, UNITED REPUBLIC OF
BARCTZTZ	ABSA BANK TANZANIA LIMITED	TANZANIA, UNITED REPUBLIC OF
BKIDTZTZ	BANK OF INDIA (TANZANIA) LIMITED	TANZANIA, UNITED REPUBLIC OF
BKMYTZTZ	INTERNATIONAL COMMERCIAL BANK (TANZANIA) LIMITED	TANZANIA, UNITED REPUBLIC OF
CBAFTZTZ	COMMERCIAL BANK OF AFRICA (TANZANIA) LTD	TANZANIA, UNITED REPUBLIC OF
CDSHTZTZ	China Dasheng Bank Ltd	TANZANIA, UNITED REPUBLIC OF
CITITZTZ	CITIBANK TANZANIA LTD	TANZANIA, UNITED REPUBLIC OF
CNRBTZTZ	CANARA BANK  (TANZANIA) LTD	TANZANIA, UNITED REPUBLIC OF
CORUTZTZ	CRDB BANK LIMITED	TANZANIA, UNITED REPUBLIC OF
DASUTZTZ	DAR ES SALAAM COMMUNITY BANK LTD	TANZANIA, UNITED REPUBLIC OF
DSTXTZTZ	DAR ES SALAAM STOCK EXCHANGE	TANZANIA, UNITED REPUBLIC OF
DTKETZTZ	DIAMOND TRUST BANK TANZANIA LTD	TANZANIA, UNITED REPUBLIC OF
ECOCTZTZ	ECOBANK TANZANIA LIMITED	TANZANIA, UNITED REPUBLIC OF
EQBLTZTZ	EQUITY BANK TANZANIA LIMITED	TANZANIA, UNITED REPUBLIC OF
EUAFTZTZ	BANK OF AFRICA TANZANIA LIMITED	TANZANIA, UNITED REPUBLIC OF
EXTNTZTZ	EXIMBANK (TANZANIA) LTD	TANZANIA, UNITED REPUBLIC OF
FIRNTZTX	FIRST NATIONAL BANK OF TANZANIA	TANZANIA, UNITED REPUBLIC OF
FMBZTZTX	AFRICAN BANKING CORPORATION TANZANIA LIMITED	TANZANIA, UNITED REPUBLIC OF
FNMITZTZ	FINCA MICROFINANCE BANK LIMITED	TANZANIA, UNITED REPUBLIC OF
GTBITZTZ	GUARANTY TRUST BANK TANZANIA LTD	TANZANIA, UNITED REPUBLIC OF
HABLTZTZ	HABIB AFRICAN BANK	TANZANIA, UNITED REPUBLIC OF
IMBLTZTZ	I AND M BANK (T) LIMITED	TANZANIA, UNITED REPUBLIC OF
KCBLTZTZ	KCB BANK TANZANIA LIMITED	TANZANIA, UNITED REPUBLIC OF
MBTLTZTZ	MAENDELEO BANK LTD	TANZANIA, UNITED REPUBLIC OF
MKCBTZTZ	MKOMBOZI COMMERCIAL BANK LTD	TANZANIA, UNITED REPUBLIC OF
MUOBTZTZ	MUCOBA BANK PLC	TANZANIA, UNITED REPUBLIC OF
MWCBTZTZ	MWANGA COMMUNITY BANK LTD	TANZANIA, UNITED REPUBLIC OF
MWCOTZTZ	MWALIMU COMMERCIAL BANK PLC	TANZANIA, UNITED REPUBLIC OF
NLCBTZTX	NATIONAL BANK OF COMMERCE, THE	TANZANIA, UNITED REPUBLIC OF
NMIBTZTZ	NMB BANK PLC	TANZANIA, UNITED REPUBLIC OF
PBZATZTZ	PEOPLE'S BANK OF ZANZIBAR, THE	TANZANIA, UNITED REPUBLIC OF
SBICTZTX	STANBIC BANK TANZANIA LIMITED	TANZANIA, UNITED REPUBLIC OF
SCBLTZTX	STANDARD CHARTERED BANK TANZANIA LTD	TANZANIA, UNITED REPUBLIC OF
TANZTZTX	BANK OF TANZANIA	TANZANIA, UNITED REPUBLIC OF
TAPBTZTZ	TANZANIA COMMERCIAL BANK PLC	TANZANIA, UNITED REPUBLIC OF
TARATZTZ	TANZANIA REVENUE AUTHORITY	TANZANIA, UNITED REPUBLIC OF
TZADTZTZ	TANZANIA AGRICULTURAL DEVELOPMENT BANK	TANZANIA, UNITED REPUBLIC OF
UCCTTZTZ	UCHUMI COMMERCIAL BANK LTD	TANZANIA, UNITED REPUBLIC OF
UNAFTZTZ	UNITED BANK FOR AFRICA (TANZANIA) LIMITED	TANZANIA, UNITED REPUBLIC OF
YETMTZTZ	YETU MICROFINANCE BANK PLC	TANZANIA, UNITED REPUBLIC OF
